11111111111111111111111111
1...........11...........1
1.111.11111.11.11111.111.1
1d111.11111.11.11111.111d1
1........................1
1.111.11.11111111.11.111.1
1.....11....11....11.....1
11111.11111 11 11111.11111
     1.1     BB     1.1   
     1.1 2222  2222 1.1   
     1.  2        2  .1   
     1.1 2222222222 1.1   
     1.1            1.1   
11111.11111111111111.11111
1...........11...........1
1.111.11111.11.11111.111.1
1d.11.......P........11.d1
11.11.11.11111111.11.11.11
 1......................11
 1111111111111111111111111
