1111111111111111111111111
1...........11..........1
1d111.11111.11.1111.111d1
1.......................1
1.111.11.11111111.1.111.1
1......1....11....1.....1
111111.1111 11 11111.1111
     1.1           1.1   
     1.1 2222 2222 1.1111
     1.  2   BB  2  .   P
     1.1 222222222 1.1111
     1.1           1.1   
111111.1111111111111.1111
1...........11..........1
1.111.11111.11.11111.11.1
1d.11................1.d1
11.11.11.11111111.11.1.11
 1.....................11
 111111111111111111111111
